Català|ca
Čeština|cs
Dansk|da
Deutsch|de	
Eesti|et
English|en
Español|es
Français|fr
Gaeilge|ga
Hrvatski|hr
Íslenska|is
Italiano|it
Latviešu|lv
Lietuvių |lt
Magyar|hu
Malti|mt
Nederlands|nl
Norsk|no,nn,nb
Polski|pl
Português|pt
Română|ro
Slovenski|sk
Slovenský|sl
Suomi|fi
Svenska|sv
Türkçe|tr
ייִדיש|yi
עברית|he
Ελληνικά|wl
Български |bg
Русский|ru
Српски|sr
Українська|uk
